1111111111
1CCC000101
1C0C0001E1
1CCP000101
1111111111
