11111
1CCC1
1C0C1
1CCP1
11111
