11111
1CCC1
1CEC1
1CCP1
11111
