11111111
10001001
10p01001
10000001
11111111
