1111111111111111
1000E00000C00001
10000000P0100001
10C0000000000001
1000000000000001
1000C00000001001
1000000000000001
1111111111111111
