11111
10001
10p01
10001
11111
