1111111111111111
1000000000000001
1000100000000001
10000000p0000001
1000000000000001
1000000000000001
1000000000001001
1000000000000001
1000000000000001
1111111111111111
