1111111111111111
1000000000C00001
1000100000000001
10000000P0000001
10C0000000000001
1000000000000001
1000C00000001001
1000000000000001
100000E000000001
1111111111111111
