111111111111111111111111
10P000000100000000000001
1000000001000000000000E1
100000000000000000000111
100000000100000000000001
100000000100000000000001
1000000C0000000000000001
100000000000000000000001
10000000000000C000000001
100000000000000000000001
100000000000000000000001
111111111111111111111111