111111111111111111111111
1P000000001111C000000001
111111111000011111110001
100000000100000000000001
111101110111110111010001
100101000000010100010001
100001011111110000010001
101111010000001111010001
100000000011000000000001
111111111011111111111101
1C00000000000000000000E1
111111111111111111111111